20 20
19 1
9 9
XXXXXXXXXXXXXXXXXXXX
X                  X
X XXXXXXXXXXXXXXXX X
X X              X X
X X XXXXXXXXXXXX X X
X X X          X X X
X X X XXXXXXXX X X X
X X X X      X X X X
X X X X XXXX X X X X
X X X X X XX X X X X
X X X X X XX X X X X
X X X X X XX X X X X
X X X X X    X X X X
X X X X XXXXXX X X X
X X X X        X X X
X X X XXXXXXXXXX X X
X X X            X X
X X XXXXXXXXXXXXXX X
X X                X
X XXXXXXXXXXXXXXXXXX
